20 17
3 3
20 20 20 20 20 0  0  0  0  0  0  0  0  0  0  0  0  0  0  0 
20 20 20 20 20 20 20 0  0  0  0  0  0  0  0  0  0  0  0  0 
20 20 20 20 20 20 20 20 0  0  0  0  0  0  0  0  0  0  0  22
20 20 20 20 20 20 20 20 20 20 20 20 20 20 20 20 20 20 22 22
20 20 20 20 20 20 20 20 20 20 20 20 20 20 20 20 20 9  22 22
20 20 20 20 20 20 20 20 20 20 20 20 20 20 20 20 9  22 22 22
20 20 20 20 20 20 20 20 20 20 20 20 20 20 20 20 22 22 22 22 
20 20 20 20 20 20 20 20 20 20 20 20 20 20 20 9  22 22 22 22
20 20 20 20 20 20 20 20 20 20 20 9  12 12 12 22 22 22 22 22
20 20 20 20 20 20 20 20 9  12 12 22 22 22 22 22 22 22 22 22
0  0  20 20 20 20 20 9  22 22 22 22 22 22 22 22 22 22 22 22 
0  0  0  20 20 20 20 22 22 22 22 22 22 22 22 22 22 22 22 22 
0  0  20 20 20 20 20 5  22 22 22 22 22 22 22 22 22 22 22 22
0  0  20 20 20 20 20 20 5  17 17 17 17 17 22 22 22 22 22 22 
0  0  0  20 20 20 20 20 20 20 20 20 20 20 5  22 22 22 22 22
0  0  0  0  20 20 20 20 20 20 20 20 20 20 20 5  17 17 17 17 
0  0  0  0  0  0  20 20 20 20 20 20 20 20 20 20 20 20 20 20 